	
баай+pos+N+num+sg+case+dat	баай^га^
баай+pos+N+num+sg+case+nom	баай^
баай+pos+N+num+sg+case+nom+poss+2pl	баай^гыт^
баай+pos+N+num+sg+case+nom+poss+1pl	баай^быт^
баай+pos+N+num+sg+case+nom+poss+3sg	баай^а^
баай+pos+N+num+sg+case+nom+poss+1sg	баай^ым^
баай+pos+N+num+sg+case+nom+poss+2sg	баай^ыҥ^
баай+pos+N+num+sg+case+nom+poss+3pl	баай^дара^
баай+pos+N+num+sg+case+cmpr	баай^дааҕар^
баай+pos+N+num+sg+case+part	баай^да^
баай+pos+N+num+sg+case+abl	баай^дан^
баай+pos+N+num+sg+case+com	баай^дыын^
баай+pos+N+num+sg+case+acc	баай^ы^
баай+pos+N+num+sg+case+ins	баай^ынан^
баай+pos+N+num+pl+case+nom+poss+3pl	баай^дара^
баай+pos+N+num+pl+case+dat	баай^дар^га^
баай+pos+N+num+pl+case+nom	баай^дар^
баай+pos+N+num+pl+case+nom+poss+2pl	баай^дар^гыт^
баай+pos+N+num+pl+case+nom+poss+1pl	баай^дар^быт^
баай+pos+N+num+pl+case+nom+poss+3sg	баай^дар^а^
баай+pos+N+num+pl+case+nom+poss+1sg	баай^дар^ым^
баай+pos+N+num+pl+case+nom+poss+2sg	баай^дар^ыҥ^
баай+pos+N+num+pl+case+cmpr	баай^дар^дааҕар^
баай+pos+N+num+pl+case+part	баай^дар^да^
баай+pos+N+num+pl+case+abl	баай^дар^дан^
баай+pos+N+num+pl+case+com	баай^дар^дыын^
баай+pos+N+num+pl+case+acc	баай^дар^ы^
баай+pos+N+num+pl+case+ins	баай^дар^ынан^
байхал+pos+N+num+pl+case+nom+poss+3pl	байхал^лара^
байхал+pos+N+num+pl+case+dat	байхал^лар^га^
байхал+pos+N+num+pl+case+nom	байхал^лар^
байхал+pos+N+num+pl+case+nom+poss+2pl	байхал^лар^гыт^
байхал+pos+N+num+pl+case+nom+poss+1pl	байхал^лар^быт^
байхал+pos+N+num+pl+case+nom+poss+3sg	байхал^лар^а^
байхал+pos+N+num+pl+case+nom+poss+1sg	байхал^лар^ым^
байхал+pos+N+num+pl+case+nom+poss+2sg	байхал^лар^ыҥ^
байхал+pos+N+num+pl+case+cmpr	байхал^лар^дааҕар^
байхал+pos+N+num+pl+case+part	байхал^лар^да^
байхал+pos+N+num+pl+case+abl	байхал^лар^дан^
байхал+pos+N+num+pl+case+com	байхал^лар^дыын^
байхал+pos+N+num+pl+case+acc	байхал^лар^ы^
байхал+pos+N+num+pl+case+ins	байхал^лар^ынан^
байхал+pos+N+num+sg+case+com	байхал^лыын^
байхал+pos+N+num+sg+case+dat	байхал^га^
байхал+pos+N+num+sg+case+cmpr	байхал^тааҕар^
байхал+pos+N+num+sg+case+part	байхал^та^
байхал+pos+N+num+sg+case+abl	байхал^тан^
байхал+pos+N+num+sg+case+nom	байхал^
байхал+pos+N+num+sg+case+nom+poss+3pl	байхал^лара^
байхал+pos+N+num+sg+case+nom+poss+2pl	байхал^гыт^
байхал+pos+N+num+sg+case+nom+poss+1pl	байхал^быт^
байхал+pos+N+num+sg+case+nom+poss+3sg	байхал^а^
байхал+pos+N+num+sg+case+nom+poss+1sg	байхал^ым^
байхал+pos+N+num+sg+case+nom+poss+2sg	байхал^ыҥ^
байхал+pos+N+num+sg+case+acc	байхал^ы^
байхал+pos+N+num+sg+case+ins	байхал^ынан^
балык+pos+N+num+sg+case+cmpr	балык^тааҕар^
балык+pos+N+num+sg+case+part	балык^та^
балык+pos+N+num+sg+case+abl	балык^тан^
балык+pos+N+num+sg+case+com	балык^тыын^
балык+pos+N+num+sg+case+nom	балык^
балык+pos+N+num+sg+case+nom+poss+3pl	балык^тара^
балык+pos+N+num+sg+case+nom+poss+2pl	балык^кыт^
балык+pos+N+num+sg+case+nom+poss+1pl	балык^пыт^
балык+pos+N+num+sg+case+dat	балык^ка^
балык+pos+N+num+pl+case+nom+poss+3pl	балык^тара^
балык+pos+N+num+pl+case+dat	балык^тар^га^
балык+pos+N+num+pl+case+nom	балык^тар^
балык+pos+N+num+pl+case+nom+poss+2pl	балык^тар^гыт^
балык+pos+N+num+pl+case+nom+poss+1pl	балык^тар^быт^
балык+pos+N+num+pl+case+nom+poss+3sg	балык^тар^а^
балык+pos+N+num+pl+case+nom+poss+1sg	балык^тар^ым^
балык+pos+N+num+pl+case+nom+poss+2sg	балык^тар^ыҥ^
балык+pos+N+num+pl+case+cmpr	балык^тар^дааҕар^
балык+pos+N+num+pl+case+part	балык^тар^да^
балык+pos+N+num+pl+case+abl	балык^тар^дан^
балык+pos+N+num+pl+case+com	балык^тар^дыын^
балык+pos+N+num+pl+case+acc	балык^тар^ы^
балык+pos+N+num+pl+case+ins	балык^тар^ынан^
балык+pos+N+num+sg+case+nom+poss+3sg	балыг^а^
балык+pos+N+num+sg+case+nom+poss+1sg	балыг^ым^
балык+pos+N+num+sg+case+nom+poss+2sg	балыг^ыҥ^
балык+pos+N+num+sg+case+acc	балыг^ы^
балык+pos+N+num+sg+case+ins	балыг^ынан^
лекарство+pos+N+num+sg+case+abl	эмп^тэн^
лекарство+pos+N+num+sg+case+cmpr	эмп^тээҕэр^
лекарство+pos+N+num+sg+case+com	эмп^тиин^
лекарство+pos+N+num+sg+case+part	эмп^тэ^
лекарство+pos+N+num+sg+case+nom	эмп^
лекарство+pos+N+num+sg+case+nom+poss+3pl	эмп^тэрэ^
лекарство+pos+N+num+sg+case+nom+poss+2pl	эмп^кит^
лекарство+pos+N+num+sg+case+nom+poss+1pl	эмп^пит^
лекарство+pos+N+num+sg+case+dat	эмп^кэ^
лекарство+pos+N+num+pl+case+dat	эмп^тэр^гэ^
лекарство+pos+N+num+pl+case+nom	эмп^тэр^
лекарство+pos+N+num+pl+case+nom+poss+2pl	эмп^тэр^гит^
лекарство+pos+N+num+pl+case+nom+poss+1pl	эмп^тэр^бит^
лекарство+pos+N+num+pl+case+nom+poss+3sg	эмп^тэр^э^
лекарство+pos+N+num+pl+case+nom+poss+1sg	эмп^тэр^им^
лекарство+pos+N+num+pl+case+nom+poss+2sg	эмп^тэр^иҥ^
лекарство+pos+N+num+pl+case+abl	эмп^тэр^дэн^
лекарство+pos+N+num+pl+case+cmpr	эмп^тэр^дээҕэр^
лекарство+pos+N+num+pl+case+com	эмп^тэр^диин^
лекарство+pos+N+num+pl+case+part	эмп^тэр^дэ^
лекарство+pos+N+num+pl+case+acc	эмп^тэр^и^
лекарство+pos+N+num+pl+case+ins	эмп^тэр^инэн^
лекарство+pos+N+num+pl+case+nom+poss+3pl	эмп^тэрэ^
лекарство+pos+N+num+sg+case+nom+poss+3sg	эмб^э^
лекарство+pos+N+num+sg+case+nom+poss+1sg	эмб^им^
лекарство+pos+N+num+sg+case+nom+poss+2sg	эмб^иҥ^
лекарство+pos+N+num+sg+case+acc	эмб^и^
лекарство+pos+N+num+sg+case+ins	эмб^инэн^
орон+pos+N+num+sg+case+nom+poss+1pl	ором^мут^
орон+pos+N+num+sg+case+com	орон^нуун^
орон+pos+N+num+sg+case+dat	орон^го^
орон+pos+N+num+sg+case+abl	орон^тон^
орон+pos+N+num+sg+case+cmpr	орон^тооҕор^
орон+pos+N+num+sg+case+part	орон^то^
орон+pos+N+num+sg+case+nom	орон^
орон+pos+N+num+sg+case+nom+poss+2pl	орон^гут^
орон+pos+N+num+sg+case+nom+poss+3pl	орон^норо^
орон+pos+N+num+sg+case+nom+poss+3sg	орон^о^
орон+pos+N+num+sg+case+nom+poss+1sg	орон^ум^
орон+pos+N+num+sg+case+nom+poss+2sg	орон^уҥ^
орон+pos+N+num+sg+case+acc	орон^у^
орон+pos+N+num+sg+case+ins	орон^унон^
орон+pos+N+num+pl+case+nom+poss+3pl	орон^норо^
орон+pos+N+num+pl+case+dat	орон^нор^го^
орон+pos+N+num+pl+case+nom	орон^нор^
орон+pos+N+num+pl+case+nom+poss+2pl	орон^нор^гут^
орон+pos+N+num+pl+case+nom+poss+1pl	орон^нор^бут^
орон+pos+N+num+pl+case+nom+poss+3sg	орон^нор^о^
орон+pos+N+num+pl+case+nom+poss+1sg	орон^нор^ум^
орон+pos+N+num+pl+case+nom+poss+2sg	орон^нор^уҥ^
орон+pos+N+num+pl+case+acc	орон^нор^у^
орон+pos+N+num+pl+case+ins	орон^нор^унон^
орон+pos+N+num+pl+case+abl	орон^нор^дон^
орон+pos+N+num+pl+case+cmpr	орон^нор^дооҕор^
орон+pos+N+num+pl+case+part	орон^нор^до^
орон+pos+N+num+pl+case+com	орон^нор^дуун^
таба+pos+N+num+pl+case+nom+poss+3pl	таба^лара^
таба+pos+N+num+pl+case+dat	таба^лар^га^
таба+pos+N+num+pl+case+nom	таба^лар^
таба+pos+N+num+pl+case+nom+poss+2pl	таба^лар^гыт^
таба+pos+N+num+pl+case+nom+poss+1pl	таба^лар^быт^
таба+pos+N+num+pl+case+nom+poss+3sg	таба^лар^а^
таба+pos+N+num+pl+case+nom+poss+1sg	таба^лар^ым^
таба+pos+N+num+pl+case+nom+poss+2sg	таба^лар^ыҥ^
таба+pos+N+num+pl+case+cmpr	таба^лар^дааҕар^
таба+pos+N+num+pl+case+part	таба^лар^да^
таба+pos+N+num+pl+case+abl	таба^лар^дан^
таба+pos+N+num+pl+case+com	таба^лар^дыын^
таба+pos+N+num+pl+case+acc	таба^лар^ы^
таба+pos+N+num+pl+case+ins	таба^лар^ынан^
таба+pos+N+num+sg+case+com	таба^лыын^
таба+pos+N+num+sg+case+ins	таба^нан^
таба+pos+N+num+sg+case+acc	таба^ны^
таба+pos+N+num+sg+case+dat	таба^га^
таба+pos+N+num+sg+case+abl	таба^ттан^
таба+pos+N+num+sg+case+cmpr	таба^тааҕар^
таба+pos+N+num+sg+case+part	таба^та^
таба+pos+N+num+sg+case+nom	таба^
таба+pos+N+num+sg+case+nom+poss+3pl	таба^лара^
таба+pos+N+num+sg+case+nom+poss+2pl	таба^гыт^
таба+pos+N+num+sg+case+nom+poss+1pl	таба^быт^
таба+pos+N+num+sg+case+nom+poss+2sg	таба^ҥ^
таба+pos+N+num+sg+case+nom+poss+1sg	таба^м^
таба+pos+N+num+sg+case+nom+poss+3sg	таба^та^
GUESS+^NOUNGUESS+pos+N+num+pl+case+nom+poss+3pl	^NOUNGUESS^лара^
GUESS+^NOUNGUESS+pos+N+num+pl+case+dat	^NOUNGUESS^лар^га^
GUESS+^NOUNGUESS+pos+N+num+pl+case+nom	^NOUNGUESS^лар^
GUESS+^NOUNGUESS+pos+N+num+pl+case+nom+poss+2pl	^NOUNGUESS^лар^гыт^
GUESS+^NOUNGUESS+pos+N+num+pl+case+nom+poss+1pl	^NOUNGUESS^лар^быт^
GUESS+^NOUNGUESS+pos+N+num+pl+case+nom+poss+3sg	^NOUNGUESS^лар^а^
GUESS+^NOUNGUESS+pos+N+num+pl+case+nom+poss+1sg	^NOUNGUESS^лар^ым^
GUESS+^NOUNGUESS+pos+N+num+pl+case+nom+poss+2sg	^NOUNGUESS^лар^ыҥ^
GUESS+^NOUNGUESS+pos+N+num+pl+case+cmpr	^NOUNGUESS^лар^дааҕар^
GUESS+^NOUNGUESS+pos+N+num+pl+case+part	^NOUNGUESS^лар^да^
GUESS+^NOUNGUESS+pos+N+num+pl+case+abl	^NOUNGUESS^лар^дан^
GUESS+^NOUNGUESS+pos+N+num+pl+case+com	^NOUNGUESS^лар^дыын^
GUESS+^NOUNGUESS+pos+N+num+pl+case+acc	^NOUNGUESS^лар^ы^
GUESS+^NOUNGUESS+pos+N+num+pl+case+ins	^NOUNGUESS^лар^ынан^
GUESS+^NOUNGUESS+pos+N+num+sg+case+com	^NOUNGUESS^лыын^
GUESS+^NOUNGUESS+pos+N+num+sg+case+ins	^NOUNGUESS^нан^
GUESS+^NOUNGUESS+pos+N+num+sg+case+dat	^NOUNGUESS^га^
GUESS+^NOUNGUESS+pos+N+num+sg+case+cmpr	^NOUNGUESS^тааҕар^
GUESS+^NOUNGUESS+pos+N+num+sg+case+part	^NOUNGUESS^та^
GUESS+^NOUNGUESS+pos+N+num+sg+case+abl	^NOUNGUESS^тан^
GUESS+^NOUNGUESS+pos+N+num+sg+case+nom	^NOUNGUESS^
GUESS+^NOUNGUESS+pos+N+num+sg+case+nom+poss+3pl	^NOUNGUESS^лара^
GUESS+^NOUNGUESS+pos+N+num+sg+case+nom+poss+2pl	^NOUNGUESS^гыт^
GUESS+^NOUNGUESS+pos+N+num+sg+case+nom+poss+1pl	^NOUNGUESS^быт^
GUESS+^NOUNGUESS+pos+N+num+sg+case+nom+poss+2sg	^NOUNGUESS^ҥ^
GUESS+^NOUNGUESS+pos+N+num+sg+case+nom+poss+1sg	^NOUNGUESS^м^
GUESS+^NOUNGUESS+pos+N+num+sg+case+nom+poss+3sg	^NOUNGUESS^а^
GUESS+^NOUNGUESS+pos+N+num+sg+case+acc	^NOUNGUESS^ы^
