бар+pos+V+deriv+attd+tense+pres+num+sg+pers+3	бар^аахд^ыыр
бар+pos+V+deriv+attd+tense+pres+num+sg+pers+1	бар^аахд^ыыр^бын
бар+pos+V+deriv+attd+tense+pres+num+pl+pers+1	бар^аахд^ыыр^быт
бар+pos+V+deriv+attd+tense+pres+num+pl+pers+3	бар^аахд^ыыр^дар
бар+pos+V+deriv+attd+tense+pres+num+pl+pers+2	бар^аахд^ыыр^гыт
бар+pos+V+deriv+attd+tense+pres+num+sg+pers+2	бар^аахд^ыыр^гын
бар+pos+V+deriv+attd+cvb.ant+num+sg+pers+1	бар^аахтаа^ам^мын
бар+pos+V+deriv+attd+cvb.ant+num+pl+pers+1	бар^аахтаа^ам^мыт
бар+pos+V+deriv+attd+cvb.ant	бар^аахтаа^ан
бар+pos+V+deriv+attd+cvb.ant+num+sg+pers+3	бар^аахтаа^ан
бар+pos+V+deriv+attd+cvb.ant+num+sg+pers+2	бар^аахтаа^ан^ҥын
бар+pos+V+deriv+attd+cvb.ant+num+pl+pers+2	бар^аахтаа^ан^ҥыт
бар+pos+V+deriv+attd+cvb.ant+num+pl+pers+3	бар^аахтаа^ан^нар
бар+pos+V+deriv+attd+ptcp.pres+polarity+neg+num+sg+case+acc	бар^аахтаа^бад^ы
бар+pos+V+deriv+attd+ptcp.pres+polarity+neg+num+sg+case+ins	бар^аахтаа^бад^ынан
бар+pos+V+deriv+attd+ptcp.pres+polarity+neg+num+sg+case+nom+poss+3sg	бар^аахтаа^бад^а
бар+pos+V+deriv+attd+ptcp.pres+polarity+neg+num+sg+case+nom+poss+1sg	бар^аахтаа^бад^ым
бар+pos+V+deriv+attd+ptcp.pres+polarity+neg+num+sg+case+nom+poss+2sg	бар^аахтаа^бад^ыҥ
бар+pos+V+deriv+attd+ptcp.pres+polarity+neg+num+sg+case+nom+poss+1pl	бар^аахтаа^бап^пыт
бар+pos+V+deriv+attd+ptcp.pres+polarity+neg+num+sg+case+nom	бар^аахтаа^бат
бар+pos+V+deriv+attd+ptcp.pres+polarity+neg+num+sg+case+dat	бар^аахтаа^бат^га
бар+pos+V+deriv+attd+ptcp.pres+polarity+neg+num+sg+case+cmpr	бар^аахтаа^бат^тааҕар
бар+pos+V+deriv+attd+ptcp.pres+polarity+neg+num+sg+case+part	бар^аахтаа^бат^та
бар+pos+V+deriv+attd+ptcp.pres+polarity+neg+num+sg+case+abl	бар^аахтаа^бат^тан
бар+pos+V+deriv+attd+ptcp.pres+polarity+neg+num+sg+case+com	бар^аахтаа^бат^тыын
бар+pos+V+deriv+attd+ptcp.pres+polarity+neg+num+sg+case+nom+poss+2pl	бар^аахтаа^бат^гыт
бар+pos+V+deriv+attd+ptcp.pres+polarity+neg+num+sg+case+nom+poss+3pl	бар^аахтаа^бат^тара
бар+pos+V+deriv+attd+ptcp.pres+polarity+neg+num+pl+case+dat	бар^аахтаа^бат^тар^га
бар+pos+V+deriv+attd+ptcp.pres+polarity+neg+num+pl+case+acc	бар^аахтаа^бат^тар^ы
бар+pos+V+deriv+attd+ptcp.pres+polarity+neg+num+pl+case+ins	бар^аахтаа^бат^тар^ынан
бар+pos+V+deriv+attd+ptcp.pres+polarity+neg+num+pl+case+nom+poss+2pl	бар^аахтаа^бат^тар^гыт
бар+pos+V+deriv+attd+ptcp.pres+polarity+neg+num+pl+case+nom+poss+3sg	бар^аахтаа^бат^тар^а
бар+pos+V+deriv+attd+ptcp.pres+polarity+neg+num+pl+case+nom+poss+1sg	бар^аахтаа^бат^тар^ым
бар+pos+V+deriv+attd+ptcp.pres+polarity+neg+num+pl+case+nom+poss+2sg	бар^аахтаа^бат^тар^ыҥ
бар+pos+V+deriv+attd+ptcp.pres+polarity+neg+num+pl+case+nom+poss+1pl	бар^аахтаа^бат^тар^быт
бар+pos+V+deriv+attd+ptcp.pres+polarity+neg+num+pl+case+cmpr	бар^аахтаа^бат^тар^дааҕар
бар+pos+V+deriv+attd+ptcp.pres+polarity+neg+num+pl+case+part	бар^аахтаа^бат^тар^да
бар+pos+V+deriv+attd+ptcp.pres+polarity+neg+num+pl+case+abl	бар^аахтаа^бат^тар^дан
бар+pos+V+deriv+attd+ptcp.pres+polarity+neg+num+pl+case+com	бар^аахтаа^бат^тар^дыын
бар+pos+V+deriv+attd+ptcp.pres+polarity+neg+num+pl+case+nom	бар^аахтаа^бат^тар
бар+pos+V+deriv+attd+ptcp.pres+polarity+neg+num+pl+case+nom+poss+3pl	бар^аахтаа^бат^тара
бар+pos+V+deriv+attd+ptcp.pres+num+sg+case+nom	бар^аахтаа^ар
бар+pos+V+deriv+attd+ptcp.pres+num+sg+case+dat	бар^аахтаа^ар^га
бар+pos+V+deriv+attd+ptcp.pres+num+sg+case+acc	бар^аахтаа^ар^ы
бар+pos+V+deriv+attd+ptcp.pres+num+sg+case+ins	бар^аахтаа^ар^ынан
бар+pos+V+deriv+attd+ptcp.pres+num+sg+case+nom+poss+2pl	бар^аахтаа^ар^гыт
бар+pos+V+deriv+attd+ptcp.pres+num+sg+case+nom+poss+3sg	бар^аахтаа^ар^а
бар+pos+V+deriv+attd+ptcp.pres+num+sg+case+nom+poss+1sg	бар^аахтаа^ар^ым
бар+pos+V+deriv+attd+ptcp.pres+num+sg+case+nom+poss+2sg	бар^аахтаа^ар^ыҥ
бар+pos+V+deriv+attd+ptcp.pres+num+sg+case+nom+poss+1pl	бар^аахтаа^ар^быт
бар+pos+V+deriv+attd+ptcp.pres+num+sg+case+nom+poss+3pl	бар^аахтаа^ар^дара
бар+pos+V+deriv+attd+ptcp.pres+num+sg+case+cmpr	бар^аахтаа^ар^дааҕар
бар+pos+V+deriv+attd+ptcp.pres+num+sg+case+part	бар^аахтаа^ар^да
бар+pos+V+deriv+attd+ptcp.pres+num+sg+case+abl	бар^аахтаа^ар^дан
бар+pos+V+deriv+attd+ptcp.pres+num+sg+case+com	бар^аахтаа^ар^дыын
бар+pos+V+deriv+attd+ptcp.pres+num+pl+case+dat	бар^аахтаа^ар^дар^га
бар+pos+V+deriv+attd+ptcp.pres+num+pl+case+acc	бар^аахтаа^ар^дар^ы
бар+pos+V+deriv+attd+ptcp.pres+num+pl+case+ins	бар^аахтаа^ар^дар^ынан
бар+pos+V+deriv+attd+ptcp.pres+num+pl+case+nom+poss+2pl	бар^аахтаа^ар^дар^гыт
бар+pos+V+deriv+attd+ptcp.pres+num+pl+case+nom+poss+3sg	бар^аахтаа^ар^дар^а
бар+pos+V+deriv+attd+ptcp.pres+num+pl+case+nom+poss+1sg	бар^аахтаа^ар^дар^ым
бар+pos+V+deriv+attd+ptcp.pres+num+pl+case+nom+poss+2sg	бар^аахтаа^ар^дар^ыҥ
бар+pos+V+deriv+attd+ptcp.pres+num+pl+case+nom+poss+1pl	бар^аахтаа^ар^дар^быт
бар+pos+V+deriv+attd+ptcp.pres+num+pl+case+cmpr	бар^аахтаа^ар^дар^дааҕар
бар+pos+V+deriv+attd+ptcp.pres+num+pl+case+part	бар^аахтаа^ар^дар^да
бар+pos+V+deriv+attd+ptcp.pres+num+pl+case+abl	бар^аахтаа^ар^дар^дан
бар+pos+V+deriv+attd+ptcp.pres+num+pl+case+com	бар^аахтаа^ар^дар^дыын
бар+pos+V+deriv+attd+ptcp.pres+num+pl+case+nom	бар^аахтаа^ар^дар
бар+pos+V+deriv+attd+ptcp.pres+num+pl+case+nom+poss+3pl	бар^аахтаа^ар^дара
бар+pos+V+deriv+attd+tense+pres+polarity+neg+num+pl+pers+1	бар^аахтаа^бап^пыт
бар+pos+V+deriv+attd+tense+pres+polarity+neg+num+sg+pers+1	бар^аахтаа^бап^пын
бар+pos+V+deriv+attd+tense+pres+polarity+neg+num+pl+pers+2	бар^аахтаа^бак^кыт
бар+pos+V+deriv+attd+tense+pres+polarity+neg+num+sg+pers+2	бар^аахтаа^бак^кын
бар+pos+V+deriv+attd+tense+pres+polarity+neg+num+sg+pers+3	бар^аахтаа^бат
бар+pos+V+deriv+attd+tense+pres+polarity+neg+num+pl+pers+3	бар^аахтаа^бат^тар
бар+pos+V+deriv+attd+tense+pst.res1+polarity+neg+num+sg+pers+3	бар^аахтаа^батах
бар+pos+V+deriv+attd+tense+pst.res1+polarity+neg+num+pl+pers+1	бар^аахтаа^батах^пыт
бар+pos+V+deriv+attd+tense+pst.res1+polarity+neg+num+pl+pers+3	бар^аахтаа^батах^тар
бар+pos+V+deriv+attd+tense+pst.res1+polarity+neg+num+pl+pers+2	бар^аахтаа^батах^хыт
бар+pos+V+deriv+attd+tense+pst.res1+polarity+neg+num+sg+pers+1	бар^аахтаа^батах^пын
бар+pos+V+deriv+attd+tense+pst.res1+polarity+neg+num+sg+pers+2	бар^аахтаа^батах^хын
бар+pos+V+deriv+attd+tense+pst.res1+num+sg+pers+3	бар^аахтаа^быт
бар+pos+V+deriv+attd+tense+pst.res1+num+pl+pers+3	бар^аахтаа^быт^тар
бар+pos+V+deriv+attd+tense+pst.res1+num+pl+pers+1	бар^аахтаа^бып^пыт
бар+pos+V+deriv+attd+tense+pst.res1+num+sg+pers+1	бар^аахтаа^бып^пын
бар+pos+V+deriv+attd+tense+pst.res1+num+pl+pers+2	бар^аахтаа^бык^кыт
бар+pos+V+deriv+attd+tense+pst.res1+num+sg+pers+2	бар^аахтаа^бык^кын
бар+pos+V+deriv+attd+tense+pst.narr+polarity+neg+num+pl+pers+1	бар^аахтаа^батах^пыт
бар+pos+V+deriv+attd+tense+pst.narr+polarity+neg+num+pl+pers+3	бар^аахтаа^батах^тара
бар+pos+V+deriv+attd+tense+pst.narr+polarity+neg+num+pl+pers+2	бар^аахтаа^батах^хыт
бар+pos+V+deriv+attd+tense+pst.narr+polarity+neg+num+sg+pers+1	бар^аахтаа^батаҕ^ым
бар+pos+V+deriv+attd+tense+pst.narr+polarity+neg+num+sg+pers+2	бар^аахтаа^батаҕ^ыҥ
бар+pos+V+deriv+attd+tense+pst.narr+polarity+neg+num+sg+pers+3	бар^аахтаа^батаҕ^а
бар+pos+V+deriv+attd+tense+pst.narr+num+sg+pers+1	бар^аахтаа^быд^ым
бар+pos+V+deriv+attd+tense+pst.narr+num+sg+pers+2	бар^аахтаа^быд^ыҥ
бар+pos+V+deriv+attd+tense+pst.narr+num+sg+pers+3	бар^аахтаа^быд^а
бар+pos+V+deriv+attd+tense+pst.narr+num+pl+pers+3	бар^аахтаа^быт^тара
бар+pos+V+deriv+attd+tense+pst.narr+num+pl+pers+1	бар^аахтаа^бып^пыт
бар+pos+V+deriv+attd+tense+pst.narr+num+pl+pers+2	бар^аахтаа^бык^кыт
бар+pos+V+deriv+attd+tense+impf+polarity+neg+num+sg+pers+1	бар^аахтаа^бад^ым
бар+pos+V+deriv+attd+tense+impf+polarity+neg+num+sg+pers+2	бар^аахтаа^бад^ыҥ
бар+pos+V+deriv+attd+tense+impf+polarity+neg+num+sg+pers+3	бар^аахтаа^бад^а
бар+pos+V+deriv+attd+tense+impf+polarity+neg+num+pl+pers+1	бар^аахтаа^бап^пыт
бар+pos+V+deriv+attd+tense+impf+polarity+neg+num+pl+pers+2	бар^аахтаа^бак^кыт
бар+pos+V+deriv+attd+tense+impf+polarity+neg+num+pl+pers+3	бар^аахтаа^бат^тара
бар+pos+V+deriv+attd+tense+fut+num+sg+pers+3	бар^аахтаа^ыа
бар+pos+V+deriv+attd+tense+fut+num+sg+pers+1	бар^аахтаа^ыа^м
бар+pos+V+deriv+attd+tense+fut+num+sg+pers+2	бар^аахтаа^ыа^ҥ
бар+pos+V+deriv+attd+tense+fut+polarity+neg+num+sg+pers+3	бар^аахтаа^ыа
бар+pos+V+deriv+attd+tense+fut+polarity+neg+num+sg+pers+1	бар^аахтаа^ыа^м
бар+pos+V+deriv+attd+tense+fut+polarity+neg+num+sg+pers+2	бар^аахтаа^ыа^ҥ
бар+pos+V+deriv+attd+tense+impf+num+pl+pers+1	бар^аахтаа^ар^быт
бар+pos+V+deriv+attd+tense+impf+num+pl+pers+3	бар^аахтаа^ар^дара
бар+pos+V+deriv+attd+tense+impf+num+pl+pers+2	бар^аахтаа^ар^гыт
бар+pos+V+deriv+attd+tense+impf+num+sg+pers+1	бар^аахтаа^ар^ым
бар+pos+V+deriv+attd+tense+impf+num+sg+pers+2	бар^аахтаа^ар^ыҥ
бар+pos+V+deriv+attd+tense+impf+num+sg+pers+3	бар^аахтаа^ар^а
бар+pos+V+deriv+attd+tense+fut+num+pl+pers+1	бар^аахтаа^ыах^пыт
бар+pos+V+deriv+attd+tense+fut+num+pl+pers+3	бар^аахтаа^ыах^тара
бар+pos+V+deriv+attd+tense+fut+num+pl+pers+2	бар^аахтаа^ыах^хыт
бар+pos+V+deriv+attd+tense+fut+num+sg+pers+1	бар^аахтаа^ыаҕ^ым
бар+pos+V+deriv+attd+tense+fut+num+sg+pers+2	бар^аахтаа^ыаҕ^ыҥ
бар+pos+V+deriv+attd+tense+fut+num+sg+pers+3	бар^аахтаа^ыаҕ^а
бар+pos+V+deriv+attd+tense+fut+polarity+neg+num+pl+pers+1	бар^аахтаа^ыах^пыт
бар+pos+V+deriv+attd+tense+fut+polarity+neg+num+pl+pers+3	бар^аахтаа^ыах^тара
бар+pos+V+deriv+attd+tense+fut+polarity+neg+num+pl+pers+2	бар^аахтаа^ыах^хыт
бар+pos+V+deriv+ag.nom+num+sg+case+nom	бар^ааччы
бар+pos+V+deriv+ag.nom+num+sg+case+acc	бар^ааччы^ны
бар+pos+V+deriv+ag.nom+num+sg+case+ins	бар^ааччы^нан
бар+pos+V+deriv+ag.nom+num+sg+case+dat	бар^ааччы^га
бар+pos+V+deriv+ag.nom+num+sg+case+cmpr	бар^ааччы^тааҕар
бар+pos+V+deriv+ag.nom+num+sg+case+part	бар^ааччы^та
бар+pos+V+deriv+ag.nom+num+sg+case+abl	бар^ааччы^ттан
бар+pos+V+deriv+ag.nom+num+sg+case+nom+poss+2pl	бар^ааччы^гыт
бар+pos+V+deriv+ag.nom+num+sg+case+nom+poss+1sg	бар^ааччы^м
бар+pos+V+deriv+ag.nom+num+sg+case+nom+poss+3pl	бар^ааччы^лара
бар+pos+V+deriv+ag.nom+num+sg+case+nom+poss+1pl	бар^ааччы^быт
бар+pos+V+deriv+ag.nom+num+sg+case+nom+poss+3sg	бар^ааччы^та
бар+pos+V+deriv+ag.nom+num+sg+case+nom+poss+2sg	бар^ааччы^ҥ
бар+pos+V+deriv+ag.nom+num+sg+case+com	бар^ааччы^лыын
бар+pos+V+deriv+ag.nom+num+pl+case+dat	бар^ааччы^лар^га
бар+pos+V+deriv+ag.nom+num+pl+case+acc	бар^ааччы^лар^ы
бар+pos+V+deriv+ag.nom+num+pl+case+ins	бар^ааччы^лар^ынан
бар+pos+V+deriv+ag.nom+num+pl+case+nom+poss+2pl	бар^ааччы^лар^гыт
бар+pos+V+deriv+ag.nom+num+pl+case+nom+poss+3sg	бар^ааччы^лар^а
бар+pos+V+deriv+ag.nom+num+pl+case+nom+poss+1sg	бар^ааччы^лар^ым
бар+pos+V+deriv+ag.nom+num+pl+case+nom+poss+2sg	бар^ааччы^лар^ыҥ
бар+pos+V+deriv+ag.nom+num+pl+case+nom+poss+1pl	бар^ааччы^лар^быт
бар+pos+V+deriv+ag.nom+num+pl+case+cmpr	бар^ааччы^лар^дааҕар
бар+pos+V+deriv+ag.nom+num+pl+case+part	бар^ааччы^лар^да
бар+pos+V+deriv+ag.nom+num+pl+case+abl	бар^ааччы^лар^дан
бар+pos+V+deriv+ag.nom+num+pl+case+com	бар^ааччы^лар^дыын
бар+pos+V+deriv+ag.nom+num+pl+case+nom	бар^ааччы^лар
бар+pos+V+deriv+ag.nom+num+pl+case+nom+poss+3pl	бар^ааччы^лара
бар+pos+V+cvb.ant+num+sg+pers+1	бар^ам^мын
бар+pos+V+cvb.ant+num+pl+pers+1	бар^ам^мыт
бар+pos+V+cvb.ant	бар^ан
бар+pos+V+cvb.ant+num+sg+pers+3	бар^ан
бар+pos+V+cvb.ant+num+sg+pers+2	бар^ан^ҥын
бар+pos+V+cvb.ant+num+pl+pers+2	бар^ан^ҥыт
бар+pos+V+cvb.ant+num+pl+pers+3	бар^ан^нар
бар+pos+V+ptcp.pres+polarity+neg+num+sg+case+acc	бар^бад^ы
бар+pos+V+ptcp.pres+polarity+neg+num+sg+case+ins	бар^бад^ынан
бар+pos+V+ptcp.pres+polarity+neg+num+sg+case+nom+poss+3sg	бар^бад^а
бар+pos+V+ptcp.pres+polarity+neg+num+sg+case+nom+poss+1sg	бар^бад^ым
бар+pos+V+ptcp.pres+polarity+neg+num+sg+case+nom+poss+2sg	бар^бад^ыҥ
бар+pos+V+ptcp.pres+polarity+neg+num+sg+case+nom+poss+1pl	бар^бап^пыт
бар+pos+V+ptcp.pres+polarity+neg+num+sg+case+nom	бар^бат
бар+pos+V+ptcp.pres+polarity+neg+num+sg+case+dat	бар^бат^га
бар+pos+V+ptcp.pres+polarity+neg+num+sg+case+cmpr	бар^бат^тааҕар
бар+pos+V+ptcp.pres+polarity+neg+num+sg+case+part	бар^бат^та
бар+pos+V+ptcp.pres+polarity+neg+num+sg+case+abl	бар^бат^тан
бар+pos+V+ptcp.pres+polarity+neg+num+sg+case+com	бар^бат^тыын
бар+pos+V+ptcp.pres+polarity+neg+num+sg+case+nom+poss+2pl	бар^бат^гыт
бар+pos+V+ptcp.pres+polarity+neg+num+sg+case+nom+poss+3pl	бар^бат^тара
бар+pos+V+ptcp.pres+polarity+neg+num+pl+case+dat	бар^бат^тар^га
бар+pos+V+ptcp.pres+polarity+neg+num+pl+case+acc	бар^бат^тар^ы
бар+pos+V+ptcp.pres+polarity+neg+num+pl+case+ins	бар^бат^тар^ынан
бар+pos+V+ptcp.pres+polarity+neg+num+pl+case+nom+poss+2pl	бар^бат^тар^гыт
бар+pos+V+ptcp.pres+polarity+neg+num+pl+case+nom+poss+3sg	бар^бат^тар^а
бар+pos+V+ptcp.pres+polarity+neg+num+pl+case+nom+poss+1sg	бар^бат^тар^ым
бар+pos+V+ptcp.pres+polarity+neg+num+pl+case+nom+poss+2sg	бар^бат^тар^ыҥ
бар+pos+V+ptcp.pres+polarity+neg+num+pl+case+nom+poss+1pl	бар^бат^тар^быт
бар+pos+V+ptcp.pres+polarity+neg+num+pl+case+cmpr	бар^бат^тар^дааҕар
бар+pos+V+ptcp.pres+polarity+neg+num+pl+case+part	бар^бат^тар^да
бар+pos+V+ptcp.pres+polarity+neg+num+pl+case+abl	бар^бат^тар^дан
бар+pos+V+ptcp.pres+polarity+neg+num+pl+case+com	бар^бат^тар^дыын
бар+pos+V+ptcp.pres+polarity+neg+num+pl+case+nom	бар^бат^тар
бар+pos+V+ptcp.pres+polarity+neg+num+pl+case+nom+poss+3pl	бар^бат^тара
бар+pos+V+ptcp.pres+num+sg+case+nom	бар^ар
бар+pos+V+ptcp.pres+num+sg+case+dat	бар^ар^га
бар+pos+V+ptcp.pres+num+sg+case+acc	бар^ар^ы
бар+pos+V+ptcp.pres+num+sg+case+ins	бар^ар^ынан
бар+pos+V+ptcp.pres+num+sg+case+nom+poss+2pl	бар^ар^гыт
бар+pos+V+ptcp.pres+num+sg+case+nom+poss+3sg	бар^ар^а
бар+pos+V+ptcp.pres+num+sg+case+nom+poss+1sg	бар^ар^ым
бар+pos+V+ptcp.pres+num+sg+case+nom+poss+2sg	бар^ар^ыҥ
бар+pos+V+ptcp.pres+num+sg+case+nom+poss+1pl	бар^ар^быт
бар+pos+V+ptcp.pres+num+sg+case+nom+poss+3pl	бар^ар^дара
бар+pos+V+ptcp.pres+num+sg+case+cmpr	бар^ар^дааҕар
бар+pos+V+ptcp.pres+num+sg+case+part	бар^ар^да
бар+pos+V+ptcp.pres+num+sg+case+abl	бар^ар^дан
бар+pos+V+ptcp.pres+num+sg+case+com	бар^ар^дыын
бар+pos+V+ptcp.pres+num+pl+case+dat	бар^ар^дар^га
бар+pos+V+ptcp.pres+num+pl+case+acc	бар^ар^дар^ы
бар+pos+V+ptcp.pres+num+pl+case+ins	бар^ар^дар^ынан
бар+pos+V+ptcp.pres+num+pl+case+nom+poss+2pl	бар^ар^дар^гыт
бар+pos+V+ptcp.pres+num+pl+case+nom+poss+3sg	бар^ар^дар^а
бар+pos+V+ptcp.pres+num+pl+case+nom+poss+1sg	бар^ар^дар^ым
бар+pos+V+ptcp.pres+num+pl+case+nom+poss+2sg	бар^ар^дар^ыҥ
бар+pos+V+ptcp.pres+num+pl+case+nom+poss+1pl	бар^ар^дар^быт
бар+pos+V+ptcp.pres+num+pl+case+cmpr	бар^ар^дар^дааҕар
бар+pos+V+ptcp.pres+num+pl+case+part	бар^ар^дар^да
бар+pos+V+ptcp.pres+num+pl+case+abl	бар^ар^дар^дан
бар+pos+V+ptcp.pres+num+pl+case+com	бар^ар^дар^дыын
бар+pos+V+ptcp.pres+num+pl+case+nom	бар^ар^дар
бар+pos+V+ptcp.pres+num+pl+case+nom+poss+3pl	бар^ар^дара
бар+pos+V+tense+pres+polarity+neg+num+pl+pers+1	бар^бап^пыт
бар+pos+V+tense+pres+polarity+neg+num+sg+pers+1	бар^бап^пын
бар+pos+V+tense+pres+polarity+neg+num+pl+pers+2	бар^бак^кыт
бар+pos+V+tense+pres+polarity+neg+num+sg+pers+2	бар^бак^кын
бар+pos+V+tense+pres+polarity+neg+num+sg+pers+3	бар^бат
бар+pos+V+tense+pres+polarity+neg+num+pl+pers+3	бар^бат^тар
бар+pos+V+tense+pst.res1+polarity+neg+num+sg+pers+3	бар^батах
бар+pos+V+tense+pst.res1+polarity+neg+num+pl+pers+1	бар^батах^пыт
бар+pos+V+tense+pst.res1+polarity+neg+num+pl+pers+3	бар^батах^тар
бар+pos+V+tense+pst.res1+polarity+neg+num+pl+pers+2	бар^батах^хыт
бар+pos+V+tense+pst.res1+polarity+neg+num+sg+pers+1	бар^батах^пын
бар+pos+V+tense+pst.res1+polarity+neg+num+sg+pers+2	бар^батах^хын
бар+pos+V+tense+pst.res1+num+sg+pers+3	бар^быт
бар+pos+V+tense+pst.res1+num+pl+pers+3	бар^быт^тар
бар+pos+V+tense+pst.res1+num+pl+pers+1	бар^бып^пыт
бар+pos+V+tense+pst.res1+num+sg+pers+1	бар^бып^пын
бар+pos+V+tense+pst.res1+num+pl+pers+2	бар^бык^кыт
бар+pos+V+tense+pst.res1+num+sg+pers+2	бар^бык^кын
бар+pos+V+tense+pst.narr+polarity+neg+num+pl+pers+1	бар^батах^пыт
бар+pos+V+tense+pst.narr+polarity+neg+num+pl+pers+3	бар^батах^тара
бар+pos+V+tense+pst.narr+polarity+neg+num+pl+pers+2	бар^батах^хыт
бар+pos+V+tense+pst.narr+polarity+neg+num+sg+pers+1	бар^батаҕ^ым
бар+pos+V+tense+pst.narr+polarity+neg+num+sg+pers+2	бар^батаҕ^ыҥ
бар+pos+V+tense+pst.narr+polarity+neg+num+sg+pers+3	бар^батаҕ^а
бар+pos+V+tense+pst.narr+num+sg+pers+1	бар^быд^ым
бар+pos+V+tense+pst.narr+num+sg+pers+2	бар^быд^ыҥ
бар+pos+V+tense+pst.narr+num+sg+pers+3	бар^быд^а
бар+pos+V+tense+pst.narr+num+pl+pers+3	бар^быт^тара
бар+pos+V+tense+pst.narr+num+pl+pers+1	бар^бып^пыт
бар+pos+V+tense+pst.narr+num+pl+pers+2	бар^бык^кыт
бар+pos+V+tense+impf+polarity+neg+num+sg+pers+1	бар^бад^ым
бар+pos+V+tense+impf+polarity+neg+num+sg+pers+2	бар^бад^ыҥ
бар+pos+V+tense+impf+polarity+neg+num+sg+pers+3	бар^бад^а
бар+pos+V+tense+impf+polarity+neg+num+pl+pers+1	бар^бап^пыт
бар+pos+V+tense+impf+polarity+neg+num+pl+pers+2	бар^бак^кыт
бар+pos+V+tense+impf+polarity+neg+num+pl+pers+3	бар^бат^тара
бар+pos+V+tense+fut+num+sg+pers+3	бар^ыа
бар+pos+V+tense+fut+num+sg+pers+1	бар^ыа^м
бар+pos+V+tense+fut+num+sg+pers+2	бар^ыа^ҥ
бар+pos+V+tense+fut+polarity+neg+num+sg+pers+3	бар^ыа
бар+pos+V+tense+fut+polarity+neg+num+sg+pers+1	бар^ыа^м
бар+pos+V+tense+fut+polarity+neg+num+sg+pers+2	бар^ыа^ҥ
бар+pos+V+tense+pres+num+pl+pers+3	бар^ал^лар
бар+pos+V+tense+impf+num+pl+pers+1	бар^ар^быт
бар+pos+V+tense+impf+num+pl+pers+3	бар^ар^дара
бар+pos+V+tense+impf+num+pl+pers+2	бар^ар^гыт
бар+pos+V+tense+impf+num+sg+pers+1	бар^ар^ым
бар+pos+V+tense+impf+num+sg+pers+2	бар^ар^ыҥ
бар+pos+V+tense+impf+num+sg+pers+3	бар^ар^а
бар+pos+V+tense+pres+num+sg+pers+1	бар^а^бын
бар+pos+V+tense+pres+num+sg+pers+2	бар^а^ҕын
бар+pos+V+tense+pres+num+pl+pers+1	бар^а^быт
бар+pos+V+tense+pres+num+pl+pers+2	бар^а^ҕыт
бар+pos+V+deriv+dvb2+num+sg+case+nom+poss+1pl	бар^дьым^мыт
бар+pos+V+deriv+dvb2+num+sg+case+nom	бар^дьын
бар+pos+V+deriv+dvb2+num+sg+case+com	бар^дьын^ныын
бар+pos+V+deriv+dvb2+num+sg+case+dat	бар^дьын^га
бар+pos+V+deriv+dvb2+num+sg+case+cmpr	бар^дьын^тааҕар
бар+pos+V+deriv+dvb2+num+sg+case+part	бар^дьын^та
бар+pos+V+deriv+dvb2+num+sg+case+abl	бар^дьын^тан
бар+pos+V+deriv+dvb2+num+sg+case+acc	бар^дьын^ы
бар+pos+V+deriv+dvb2+num+sg+case+ins	бар^дьын^ынан
бар+pos+V+deriv+dvb2+num+sg+case+nom+poss+3pl	бар^дьын^нара
бар+pos+V+deriv+dvb2+num+sg+case+nom+poss+2pl	бар^дьын^гыт
бар+pos+V+deriv+dvb2+num+sg+case+nom+poss+3sg	бар^дьын^а
бар+pos+V+deriv+dvb2+num+sg+case+nom+poss+1sg	бар^дьын^ым
бар+pos+V+deriv+dvb2+num+sg+case+nom+poss+2sg	бар^дьын^ыҥ
бар+pos+V+deriv+dvb2+num+pl+case+dat	бар^дьын^нар^га
бар+pos+V+deriv+dvb2+num+pl+case+acc	бар^дьын^нар^ы
бар+pos+V+deriv+dvb2+num+pl+case+ins	бар^дьын^нар^ынан
бар+pos+V+deriv+dvb2+num+pl+case+nom+poss+2pl	бар^дьын^нар^гыт
бар+pos+V+deriv+dvb2+num+pl+case+nom+poss+3sg	бар^дьын^нар^а
бар+pos+V+deriv+dvb2+num+pl+case+nom+poss+1sg	бар^дьын^нар^ым
бар+pos+V+deriv+dvb2+num+pl+case+nom+poss+2sg	бар^дьын^нар^ыҥ
бар+pos+V+deriv+dvb2+num+pl+case+nom+poss+1pl	бар^дьын^нар^быт
бар+pos+V+deriv+dvb2+num+pl+case+cmpr	бар^дьын^нар^дааҕар
бар+pos+V+deriv+dvb2+num+pl+case+part	бар^дьын^нар^да
бар+pos+V+deriv+dvb2+num+pl+case+abl	бар^дьын^нар^дан
бар+pos+V+deriv+dvb2+num+pl+case+com	бар^дьын^нар^дыын
бар+pos+V+deriv+dvb2+num+pl+case+nom	бар^дьын^нар
бар+pos+V+deriv+dvb2+num+pl+case+nom+poss+3pl	бар^дьын^нара
бар+pos+V+deriv+dvb+num+sg+case+nom	бар^ыы
бар+pos+V+deriv+dvb+num+sg+case+acc	бар^ыы^ны
бар+pos+V+deriv+dvb+num+sg+case+ins	бар^ыы^нан
бар+pos+V+deriv+dvb+num+sg+case+dat	бар^ыы^га
бар+pos+V+deriv+dvb+num+sg+case+cmpr	бар^ыы^тааҕар
бар+pos+V+deriv+dvb+num+sg+case+part	бар^ыы^та
бар+pos+V+deriv+dvb+num+sg+case+abl	бар^ыы^ттан
бар+pos+V+deriv+dvb+num+sg+case+nom+poss+2pl	бар^ыы^гыт
бар+pos+V+deriv+dvb+num+sg+case+nom+poss+1sg	бар^ыы^м
бар+pos+V+deriv+dvb+num+sg+case+nom+poss+3pl	бар^ыы^лара
бар+pos+V+deriv+dvb+num+sg+case+nom+poss+1pl	бар^ыы^быт
бар+pos+V+deriv+dvb+num+sg+case+nom+poss+3sg	бар^ыы^та
бар+pos+V+deriv+dvb+num+sg+case+nom+poss+2sg	бар^ыы^ҥ
бар+pos+V+deriv+dvb+num+sg+case+com	бар^ыы^лыын
бар+pos+V+deriv+dvb+num+pl+case+dat	бар^ыы^лар^га
бар+pos+V+deriv+dvb+num+pl+case+acc	бар^ыы^лар^ы
бар+pos+V+deriv+dvb+num+pl+case+ins	бар^ыы^лар^ынан
бар+pos+V+deriv+dvb+num+pl+case+nom+poss+2pl	бар^ыы^лар^гыт
бар+pos+V+deriv+dvb+num+pl+case+nom+poss+3sg	бар^ыы^лар^а
бар+pos+V+deriv+dvb+num+pl+case+nom+poss+1sg	бар^ыы^лар^ым
бар+pos+V+deriv+dvb+num+pl+case+nom+poss+2sg	бар^ыы^лар^ыҥ
бар+pos+V+deriv+dvb+num+pl+case+nom+poss+1pl	бар^ыы^лар^быт
бар+pos+V+deriv+dvb+num+pl+case+cmpr	бар^ыы^лар^дааҕар
бар+pos+V+deriv+dvb+num+pl+case+part	бар^ыы^лар^да
бар+pos+V+deriv+dvb+num+pl+case+abl	бар^ыы^лар^дан
бар+pos+V+deriv+dvb+num+pl+case+com	бар^ыы^лар^дыын
бар+pos+V+deriv+dvb+num+pl+case+nom	бар^ыы^лар
бар+pos+V+deriv+dvb+num+pl+case+nom+poss+3pl	бар^ыы^лара
бар+pos+V+tense+pres+num+sg+pers+3	бар^ар
бар+pos+V+tense+fut+num+pl+pers+1	бар^ыах^пыт
бар+pos+V+tense+fut+num+pl+pers+3	бар^ыах^тара
бар+pos+V+tense+fut+num+pl+pers+2	бар^ыах^хыт
бар+pos+V+tense+fut+num+sg+pers+1	бар^ыаҕ^ым
бар+pos+V+tense+fut+num+sg+pers+2	бар^ыаҕ^ыҥ
бар+pos+V+tense+fut+num+sg+pers+3	бар^ыаҕ^а
бар+pos+V+tense+fut+polarity+neg+num+pl+pers+1	бар^ыах^пыт
бар+pos+V+tense+fut+polarity+neg+num+pl+pers+3	бар^ыах^тара
бар+pos+V+tense+fut+polarity+neg+num+pl+pers+2	бар^ыах^хыт
